############
#          #
#     H    #
#          #
#          #
#          #
#          #
#     P    #
############